+--------+
|S****** |
|   *  * |
|F***  * |
|   *  * |
| ***    |
+--------+
